DefaultMap
..........
..G....G..
..........
..........
....P.....
..........
..........
..G....G..
..........
..........